111111111111111111111111111111111111111111111111111
100000000000000000100000001000000000000000000000001
100006000600000000100000001000000000000000000000001
100000000000000000100000001000000000500000000000001
100000000000000000100000001000000000000005000000001
100220000200000000100000001000000200000000000000001
100000000000000000100000001000000200000050000000001
100000000000000600100000007000000000000000000000001
111111171111111111111110001111111111111111111111111
100000000000000000100000001000000000000000000000001
100000000000000600100000001000006000000606000000001
100000002000000000100000001000000000000000000000001
100000000000000000100000001000000000000000020000001
100050000000000000100000001000000000000000000000001
100000000000000000100000001000000060000002000000001
100000000020000000100000001000000000000000000000001
100000000002000000100000001111111111111111110000001
100000000000000000100000001000000000000000000000001
100000000000000000700000001000000000020000000000001
100000000002000000100000001000000000000000000000001
100050000000000000100000001000000000000000000050001
100000002000000000100000001000000020000000000050001
100050000000000000100000007000000000000000000000001
100050000000000000100000001000000000000000000000001
100000000000000000100000001000000000200000000050001
100000000000000000100000001000000000000000000000001
100000000000000000100000001000000000000000000000001
111111111111111111111711111111111111111111111111111
100000000000000000000000000000000000000000000000001
100000000020000000000000000000050000000000000000001
100000000020000000000000000005000000000000000000001
111111711111111111111111111111111111111111111111111
100000000000000000000000000000000000000000000000001
100000040000000000000000000000000000000000000000001
100000000000000000000000000000000000000000000000001
111111111111111111111111111111111111111111111111111